* * * * * * * * * * * * * * * * * * *
*                 *                 *
*   * *   * * *   *   * * *   * *   *
*                                   *
*   * *   *   * * * * *   *   * *   *
*         *       *       *         *
* * * *   * * *   *   * * *   * * * *
- - - *   *               *   * - - -
* * * *   *   * * * * *   *   * * * *
              * - - - *              
* * * *   *   * * * * *   *   * * * *
- - - *   *               *   * - - -
* * * *   *   * * * * *   *   * * * *
*                 *                 *
*   * *   * * *   *   * * *   * *   *
*     *                       *     *
* *   *   *   * * * * *   *   *   * *
*         *       *       *         *
*   * * * * * *   *   * * * * * *   *
*                                   *
* * * * * * * * * * * * * * * * * * *

